Municipality,Perfecture,population_2011,population_2021,diff,diff_pct
ΑΓΡΙΝΙΟΥ,ΑΙΤΩΛ/ΝΙΑΣ,94181,88971,-5210,"-5,5%"
ΑΚΤΙΟΥ-ΒΟΝΙΤΣΑΣ,ΑΙΤΩΛ/ΝΙΑΣ,17370,14656,-2714,"-15,6%"
ΑΜΦΙΛΟΧΙΑΣ,ΑΙΤΩΛ/ΝΙΑΣ,17056,15073,-1983,"-11,6%"
ΘΕΡΜΟΥ,ΑΙΤΩΛ/ΝΙΑΣ,8242,5742,-2500,"-30,3%"
ΙΕΡΑΣ ΠΟΛΗΣ ΜΕΣΟΛΟΓΓΙΟΥ,ΑΙΤΩΛ/ΝΙΑΣ,34416,31944,-2472,"-7,2%"
ΝΑΥΠΑΚΤΙΑΣ,ΑΙΤΩΛ/ΝΙΑΣ,27800,25121,-2679,"-9,6%"
ΞΗΡΟΜΕΡΟΥ,ΑΙΤΩΛ/ΝΙΑΣ,11737,10220,-1517,"-12,9%"
ΑΡΓΟΥΣ-ΜΥΚΗΝΩΝ,ΑΡΓΟΛΙΔΑΣ,42022,40009,-2013,"-4,8%"
ΕΠΙΔΑΥΡΟΥ,ΑΡΓΟΛΙΔΑΣ,8115,7089,-1026,"-12,6%"
ΕΡΜΙΟΝΙΔΑΣ,ΑΡΓΟΛΙΔΑΣ,13551,13598,47,"0,3%"
ΝΑΥΠΛΙΕΩΝ,ΑΡΓΟΛΙΔΑΣ,33356,32586,-770,"-2,3%"
ΒΟΡΕΙΑΣ ΚΥΝΟΥΡΙΑΣ,ΑΡΚΑΔΙΑΣ,10341,9538,-803,"-7,8%"
ΓΟΡΤΥΝΙΑΣ,ΑΡΚΑΔΙΑΣ,10109,8015,-2094,"-20,7%"
ΜΕΓΑΛΟΠΟΛΗΣ,ΑΡΚΑΔΙΑΣ,10687,8791,-1896,"-17,7%"
ΝΟΤΙΑΣ ΚΥΝΟΥΡΙΑΣ,ΑΡΚΑΔΙΑΣ,8294,7263,-1031,"-12,4%"
ΤΡΙΠΟΛΗΣ,ΑΡΚΑΔΙΑΣ,47254,43944,-3310,"-7,0%"
ΑΡΤΑΙΩΝ,ΑΡΤΗΣ,43166,41633,-1533,"-3,6%"
ΓΕΩΡΓΙΟΥ ΚΑΡΑΪΣΚΑΚΗ,ΑΡΤΗΣ,5780,5321,-459,"-7,9%"
ΚΕΝΤΡΙΚΩΝ ΤΖΟΥΜΕΡΚΩΝ,ΑΡΤΗΣ,6178,5562,-616,"-10,0%"
ΝΙΚΟΛΑΟΥ ΣΚΟΥΦΑ,ΑΡΤΗΣ,12753,11411,-1342,"-10,5%"
ΑΓΙΑΣ ΒΑΡΒΑΡΑΣ,ΑΤΤΙΚΗΣ,26550,26759,209,"0,8%"
ΑΓΙΑΣ ΠΑΡΑΣΚΕΥΗΣ,ΑΤΤΙΚΗΣ,59704,62157,2453,"4,1%"
ΑΓΙΟΥ ΔΗΜΗΤΡΙΟΥ,ΑΤΤΙΚΗΣ,71294,71747,453,"0,6%"
ΑΓΙΩΝ ΑΝΑΡΓΥΡΩΝ-ΚΑΜΑΤΕΡΟΥ,ΑΤΤΙΚΗΣ,62529,61427,-1102,"-1,8%"
ΑΓΚΙΣΤΡΙΟΥ,ΑΤΤΙΚΗΣ,1142,1107,-35,"-3,1%"
ΑΘΗΝΑΙΩΝ,ΑΤΤΙΚΗΣ,664046,637798,-26248,"-4,0%"
ΑΙΓΑΛΕΩ,ΑΤΤΙΚΗΣ,69946,64828,-5118,"-7,3%"
ΑΙΓΙΝΑΣ,ΑΤΤΙΚΗΣ,13056,12938,-118,"-0,9%"
ΑΛΙΜΟΥ,ΑΤΤΙΚΗΣ,41720,42872,1152,"2,8%"
ΑΜΑΡΟΥΣΙΟΥ,ΑΤΤΙΚΗΣ,72333,70519,-1814,"-2,5%"
ΑΣΠΡΟΠΥΡΓΟΥ,ΑΤΤΙΚΗΣ,30251,31420,1169,"3,9%"
ΑΧΑΡΝΩΝ,ΑΤΤΙΚΗΣ,106943,108130,1187,"1,1%"
ΒΑΡΗΣ-ΒΟΥΛΑΣ-ΒΟΥΛΙΑΓΜΕΝΗΣ,ΑΤΤΙΚΗΣ,48399,50585,2186,"4,5%"
ΒΡΙΛΗΣΣΙΩΝ,ΑΤΤΙΚΗΣ,30741,32422,1681,"5,5%"
ΒΥΡΩΝΟΣ,ΑΤΤΙΚΗΣ,61308,59134,-2174,"-3,5%"
ΓΑΛΑΤΣΙΟΥ,ΑΤΤΙΚΗΣ,59345,57917,-1428,"-2,4%"
ΓΛΥΦΑΔΑΣ,ΑΤΤΙΚΗΣ,87305,89605,2300,"2,6%"
ΔΑΦΝΗΣ-ΥΜΗΤΤΟΥ,ΑΤΤΙΚΗΣ,33628,33850,222,"0,7%"
ΔΙΟΝΥΣΟΥ,ΑΤΤΙΚΗΣ,40193,41748,1555,"3,9%"
ΕΛΕΥΣΙΝΑΣ,ΑΤΤΙΚΗΣ,29902,29619,-283,"-0,9%"
ΕΛΛΗΝΙΚΟΥ-ΑΡΓΥΡΟΥΠΟΛΗΣ,ΑΤΤΙΚΗΣ,51356,49722,-1634,"-3,2%"
ΖΩΓΡΑΦΟΥ,ΑΤΤΙΚΗΣ,71026,69857,-1169,"-1,6%"
ΗΛΙΟΥΠΟΛΕΩΣ,ΑΤΤΙΚΗΣ,78153,76708,-1445,"-1,8%"
ΗΡΑΚΛΕΙΟΥ,ΑΤΤΙΚΗΣ,49642,50495,853,"1,7%"
ΙΛΙΟΥ,ΑΤΤΙΚΗΣ,84793,83523,-1270,"-1,5%"
ΚΑΙΣΑΡΙΑΝΗΣ,ΑΤΤΙΚΗΣ,26458,26260,-198,"-0,7%"
ΚΑΛΛΙΘΕΑΣ,ΑΤΤΙΚΗΣ,100641,96118,-4523,"-4,5%"
ΚΕΡΑΤΣΙΝΙΟΥ-ΔΡΑΠΕΤΣΩΝΑΣ,ΑΤΤΙΚΗΣ,91045,89386,-1659,"-1,8%"
ΚΗΦΙΣΙΑΣ,ΑΤΤΙΚΗΣ,71259,72860,1601,"2,2%"
ΚΟΡΥΔΑΛΛΟΥ,ΑΤΤΙΚΗΣ,63445,61247,-2198,"-3,5%"
ΚΡΩΠΙΑΣ,ΑΤΤΙΚΗΣ,30307,29432,-875,"-2,9%"
ΚΥΘΗΡΩΝ,ΑΤΤΙΚΗΣ,4041,3237,-804,"-19,9%"
ΛΑΥΡΕΩΤΙΚΗΣ,ΑΤΤΙΚΗΣ,25102,25608,506,"2,0%"
ΛΥΚΟΒΡΥΣΗΣ-ΠΕΥΚΗΣ,ΑΤΤΙΚΗΣ,31153,30996,-157,"-0,5%"
ΜΑΝΔΡΑΣ-ΕΙΔΥΛΛΙΑΣ,ΑΤΤΙΚΗΣ,17885,17524,-361,"-2,0%"
ΜΑΡΑΘΩΝΟΣ,ΑΤΤΙΚΗΣ,33423,31448,-1975,"-5,9%"
ΜΑΡΚΟΠΟΥΛΟΥ ΜΕΣΟΓΑΙΑΣ,ΑΤΤΙΚΗΣ,20040,21284,1244,"6,2%"
ΜΕΓΑΡΕΩΝ,ΑΤΤΙΚΗΣ,36924,38046,1122,"3,0%"
ΜΕΤΑΜΟΡΦΩΣΕΩΣ,ΑΤΤΙΚΗΣ,29891,30170,279,"0,9%"
ΜΟΣΧΑΤΟΥ-ΤΑΥΡΟΥ,ΑΤΤΙΚΗΣ,40413,39507,-906,"-2,2%"
ΝΕΑΣ ΙΩΝΙΑΣ,ΑΤΤΙΚΗΣ,67134,64107,-3027,"-4,5%"
ΝΕΑΣ ΣΜΥΡΝΗΣ,ΑΤΤΙΚΗΣ,73076,72546,-530,"-0,7%"
ΝΙΚΑΙΑΣ-ΑΓΙΟΥ ΙΩΑΝΝΗ ΡΕΝΤΗ,ΑΤΤΙΚΗΣ,105430,103355,-2075,"-2,0%"
ΠΑΙΑΝΙΑΣ,ΑΤΤΙΚΗΣ,26668,27916,1248,"4,7%"
ΠΑΛΑΙΟΥ ΦΑΛΗΡΟΥ,ΑΤΤΙΚΗΣ,64021,64879,858,"1,3%"
ΠΑΛΛΗΝΗΣ,ΑΤΤΙΚΗΣ,54415,60435,6020,"11,1%"
ΠΑΠΑΓΟΥ-ΧΟΛΑΡΓΟΥ,ΑΤΤΙΚΗΣ,44539,45164,625,"1,4%"
ΠΕΙΡΑΙΩΣ,ΑΤΤΙΚΗΣ,163688,163572,-116,"-0,1%"
ΠΕΝΤΕΛΗΣ,ΑΤΤΙΚΗΣ,34934,35439,505,"1,4%"
ΠΕΡΑΜΑΤΟΣ,ΑΤΤΙΚΗΣ,25389,25636,247,"1,0%"
ΠΕΡΙΣΤΕΡΙΟΥ,ΑΤΤΙΚΗΣ,139981,132123,-7858,"-5,6%"
ΠΕΤΡΟΥΠΟΛΕΩΣ,ΑΤΤΙΚΗΣ,58979,60166,1187,"2,0%"
ΠΟΡΟΥ,ΑΤΤΙΚΗΣ,3993,3237,-756,"-18,9%"
ΡΑΦΗΝΑΣ-ΠΙΚΕΡΜΙΟΥ,ΑΤΤΙΚΗΣ,20266,22230,1964,"9,7%"
ΣΑΛΑΜΙΝΑΣ,ΑΤΤΙΚΗΣ,39283,37175,-2108,"-5,4%"
ΣΑΡΩΝΙΚΟΥ,ΑΤΤΙΚΗΣ,29002,29703,701,"2,4%"
ΣΠΑΤΩΝ-ΑΡΤΕΜΙΔΟΣ,ΑΤΤΙΚΗΣ,33821,34053,232,"0,7%"
ΣΠΕΤΣΩΝ,ΑΤΤΙΚΗΣ,4027,3680,-347,"-8,6%"
ΤΡΟΙΖΗΝΙΑΣ-ΜΕΘΑΝΩΝ,ΑΤΤΙΚΗΣ,7143,6118,-1025,"-14,3%"
ΥΔΡΑΣ,ΑΤΤΙΚΗΣ,1966,2011,45,"2,3%"
ΝΕΑΣ ΦΙΛΑΔΕΛΦΕΙΑΣ-ΝΕΑΣ ΧΑΛΚΗΔΟΝΑΣ,ΑΤΤΙΚΗΣ,33673,29951,-3722,"-11,1%"
ΦΙΛΟΘΕΗΣ-ΨΥΧΙΚΟΥ,ΑΤΤΙΚΗΣ,26968,27400,432,"1,6%"
ΦΥΛΗΣ,ΑΤΤΙΚΗΣ,45965,48255,2290,"5,0%"
ΧΑΪΔΑΡΙΟΥ,ΑΤΤΙΚΗΣ,46897,46983,86,"0,2%"
ΧΑΛΑΝΔΡΙΟΥ,ΑΤΤΙΚΗΣ,74192,77118,2926,"3,9%"
ΩΡΩΠΟΥ,ΑΤΤΙΚΗΣ,33769,33977,208,"0,6%"
ΑΙΓΙΑΛΕΙΑΣ,ΑΧΑΙΑΣ,49872,47225,-2647,"-5,3%"
ΔΥΤΙΚΗΣ ΑΧΑΪΑΣ,ΑΧΑΙΑΣ,25916,25900,-16,"-0,1%"
ΕΡΥΜΑΝΘΟΥ,ΑΧΑΙΑΣ,8877,8273,-604,"-6,8%"
ΚΑΛΑΒΡΥΤΩΝ,ΑΧΑΙΑΣ,11045,9281,-1764,"-16,0%"
ΠΑΤΡΕΩΝ,ΑΧΑΙΑΣ,213984,211593,-2391,"-1,1%"
ΑΛΙΑΡΤΟΥ-ΘΕΣΠΙΕΩΝ,ΒΟΙΩΤΙΑΣ,10887,8778,-2109,"-19,4%"
ΔΙΣΤΟΜΟΥ-ΑΡΑΧΟΒΑΣ-ΑΝΤΙΚΥΡΑΣ,ΒΟΙΩΤΙΑΣ,8188,7602,-586,"-7,2%"
ΘΗΒΑΙΩΝ,ΒΟΙΩΤΙΑΣ,36477,32521,-3956,"-10,8%"
ΛΕΒΑΔΕΩΝ,ΒΟΙΩΤΙΑΣ,31315,29393,-1922,"-6,1%"
ΟΡΧΟΜΕΝΟΥ,ΒΟΙΩΤΙΑΣ,11621,9386,-2235,"-19,2%"
ΤΑΝΑΓΡΑΣ,ΒΟΙΩΤΙΑΣ,19432,18427,-1005,"-5,2%"
ΓΡΕΒΕΝΩΝ,ΓΡΕΒΕΝΩΝ,25905,21440,-4465,"-17,2%"
ΔΕΣΚΑΤΗΣ,ΓΡΕΒΕΝΩΝ,5852,5205,-647,"-11,1%"
ΔΟΞΑΤΟΥ,ΔΡΑΜΑΣ,14516,12109,-2407,"-16,6%"
ΔΡΑΜΑΣ,ΔΡΑΜΑΣ,58944,55593,-3351,"-5,7%"
ΚΑΤΩ ΝΕΥΡΟΚΟΠΙΟΥ,ΔΡΑΜΑΣ,7860,5323,-2537,"-32,3%"
ΠΑΡΑΝΕΣΤΙΟΥ,ΔΡΑΜΑΣ,3901,2852,-1049,"-26,9%"
ΠΡΟΣΟΤΣΑΝΗΣ,ΔΡΑΜΑΣ,13066,10744,-2322,"-17,8%"
ΑΓΑΘΟΝΗΣΙΟΥ,ΔΩΔ/ΝΗΣΟΥ,185,203,18,"9,7%"
ΑΣΤΥΠΑΛΑΙΑΣ,ΔΩΔ/ΝΗΣΟΥ,1334,1399,65,"4,9%"
ΗΡΩΙΚΗΣ ΝΗΣΟΥ	ΚΑΣΟΥ,ΔΩΔ/ΝΗΣΟΥ,1084,1224,140,"12,9%"
ΚΑΛΥΜΝΙΩΝ,ΔΩΔ/ΝΗΣΟΥ,16179,17797,1618,"10,0%"
ΚΑΡΠΑΘΟΥ,ΔΩΔ/ΝΗΣΟΥ,6226,6416,190,"3,1%"
ΚΩ,ΔΩΔ/ΝΗΣΟΥ,33388,36986,3598,"10,8%"
ΛΕΙΨΩΝ,ΔΩΔ/ΝΗΣΟΥ,790,778,-12,"-1,5%"
ΛΕΡΟΥ,ΔΩΔ/ΝΗΣΟΥ,7917,7988,71,"0,9%"
ΜΕΓΙΣΤΗΣ,ΔΩΔ/ΝΗΣΟΥ,492,584,92,"18,7%"
ΝΙΣΥΡΟΥ,ΔΩΔ/ΝΗΣΟΥ,1008,1043,35,"3,5%"
ΠΑΤΜΟΥ,ΔΩΔ/ΝΗΣΟΥ,3047,3217,170,"5,6%"
ΡΟΔΟΥ,ΔΩΔ/ΝΗΣΟΥ,115490,124851,9361,"8,1%"
ΣΥΜΗΣ,ΔΩΔ/ΝΗΣΟΥ,2590,2495,-95,"-3,7%"
ΤΗΛΟΥ,ΔΩΔ/ΝΗΣΟΥ,780,745,-35,"-4,5%"
ΧΑΛΚΗΣ,ΔΩΔ/ΝΗΣΟΥ,478,476,-2,"-0,4%"
ΑΛΕΞΑΝΔΡΟΥΠΟΛΗΣ,ΕΒΡΟΥ,72959,71601,-1358,"-1,9%"
ΔΙΔΥΜΟΤΕΙΧΟΥ,ΕΒΡΟΥ,19493,16161,-3332,"-17,1%"
ΟΡΕΣΤΙΑΔΑΣ,ΕΒΡΟΥ,37695,31694,-6001,"-15,9%"
ΣΑΜΟΘΡΑΚΗΣ,ΕΒΡΟΥ,2859,2622,-237,"-8,3%"
ΣΟΥΦΛΙΟΥ,ΕΒΡΟΥ,14941,11784,-3157,"-21,1%"
ΔΙΡΦΥΩΝ-ΜΕΣΣΑΠΙΩΝ,ΕΥΒΟΙΑΣ,18800,15435,-3365,"-17,9%"
ΕΡΕΤΡΙΑΣ,ΕΥΒΟΙΑΣ,13053,12676,-377,"-2,9%"
ΙΣΤΙΑΙΑΣ-ΑΙΔΗΨΟΥ,ΕΥΒΟΙΑΣ,21083,18460,-2623,"-12,4%"
ΚΑΡΥΣΤΟΥ,ΕΥΒΟΙΑΣ,12180,11593,-587,"-4,8%"
ΚΥΜΗΣ-ΑΛΙΒΕΡΙΟΥ,ΕΥΒΟΙΑΣ,28437,26359,-2078,"-7,3%"
ΜΑΝΤΟΥΔΙΟΥ-ΛΙΜΝΗΣ-ΑΓΙΑΣ ΑΝΝΑΣ,ΕΥΒΟΙΑΣ,12045,11986,-59,"-0,5%"
ΣΚΥΡΟΥ,ΕΥΒΟΙΑΣ,2994,2913,-81,"-2,7%"
ΧΑΛΚΙΔΕΩΝ,ΕΥΒΟΙΑΣ,102223,108313,6090,"6,0%"
ΑΓΡΑΦΩΝ,ΕΥΡΥΤΑΝΙΑΣ,6976,5984,-992,"-14,2%"
ΚΑΡΠΕΝΗΣΙΟΥ,ΕΥΡΥΤΑΝΙΑΣ,13105,11477,-1628,"-12,4%"
ΖΑΚΥΝΘΟΥ,ΖΑΚΥΝΘΟΥ,40759,40508,-251,"-0,6%"
ΑΝΔΡΑΒΙΔΑΣ-ΚΥΛΛΗΝΗΣ,ΗΛΕΙΑΣ,21581,22615,1034,"4,8%"
ΑΝΔΡΙΤΣΑΙΝΑΣ-ΚΡΕΣΤΕΝΩΝ,ΗΛΕΙΑΣ,14109,11273,-2836,"-20,1%"
ΑΡΧΑΙΑΣ ΟΛΥΜΠΙΑΣ,ΗΛΕΙΑΣ,13409,11307,-2102,"-15,7%"
ΖΑΧΑΡΩΣ,ΗΛΕΙΑΣ,8953,8606,-347,"-3,9%"
ΗΛΙΔΑΣ,ΗΛΕΙΑΣ,32219,29409,-2810,"-8,7%"
ΠΗΝΕΙΟΥ,ΗΛΕΙΑΣ,21034,21658,624,"3,0%"
ΠΥΡΓΟΥ,ΗΛΕΙΑΣ,47995,44482,-3513,"-7,3%"
ΑΛΕΞΑΝΔΡΕΙΑΣ,ΗΜΑΘΙΑΣ,41570,38293,-3277,"-7,9%"
ΒΕΡΟΙΑΣ,ΗΜΑΘΙΑΣ,66547,62064,-4483,"-6,7%"
ΗΡΩΙΚΗΣ ΠΟΛΕΩΣ ΝΑΟΥΣΑΣ,ΗΜΑΘΙΑΣ,32494,29669,-2825,"-8,7%"
ΑΡΧΑΝΩΝ-ΑΣΤΕΡΟΥΣΙΩΝ,ΗΡΑΚΛΕΙΟΥ,16692,16002,-690,"-4,1%"
ΒΙΑΝΝΟΥ,ΗΡΑΚΛΕΙΟΥ,5563,4314,-1249,"-22,5%"
ΓΟΡΤΥΝΑΣ,ΗΡΑΚΛΕΙΟΥ,15632,13936,-1696,"-10,8%"
ΗΡΑΚΛΕΙΟΥ,ΗΡΑΚΛΕΙΟΥ,173993,177064,3071,"1,8%"
ΜΑΛΕΒΙΖΙΟΥ,ΗΡΑΚΛΕΙΟΥ,24864,25750,886,"3,6%"
ΜΙΝΩΑ ΠΕΔΙΑΔΑΣ,ΗΡΑΚΛΕΙΟΥ,17563,14161,-3402,"-19,4%"
ΦΑΙΣΤΟΥ,ΗΡΑΚΛΕΙΟΥ,24466,23994,-472,"-1,9%"
ΧΕΡΣΟΝΗΣΟΥ,ΗΡΑΚΛΕΙΟΥ,26717,27229,512,"1,9%"
ΗΓΟΥΜΕΝΙΤΣΑΣ,ΘΕΣΠΡΩΤΙΑΣ,25814,25709,-105,"-0,4%"
ΣΟΥΛΙΟΥ,ΘΕΣΠΡΩΤΙΑΣ,10063,8767,-1296,"-12,9%"
ΦΙΛΙΑΤΩΝ,ΘΕΣΠΡΩΤΙΑΣ,7710,6351,-1359,"-17,6%"
ΑΜΠΕΛΟΚΗΠΩΝ-ΜΕΝΕΜΕΝΗΣ,ΘΕΣ/ΝΙΚΗΣ,52127,49674,-2453,"-4,7%"
ΒΟΛΒΗΣ,ΘΕΣ/ΝΙΚΗΣ,23478,19812,-3666,"-15,6%"
ΔΕΛΤΑ,ΘΕΣ/ΝΙΚΗΣ,45839,45628,-211,"-0,5%"
ΘΕΡΜΑΪΚΟΥ,ΘΕΣ/ΝΙΚΗΣ,50264,45450,-4814,"-9,6%"
ΘΕΡΜΗΣ,ΘΕΣ/ΝΙΚΗΣ,53201,55238,2037,"3,8%"
ΘΕΣΣΑΛΟΝΙΚΗΣ,ΘΕΣ/ΝΙΚΗΣ,325182,317778,-7404,"-2,3%"
ΚΑΛΑΜΑΡΙΑΣ,ΘΕΣ/ΝΙΚΗΣ,91518,92238,720,"0,8%"
ΚΟΡΔΕΛΙΟΥ-ΕΥΟΣΜΟΥ,ΘΕΣ/ΝΙΚΗΣ,101753,105426,3673,"3,6%"
ΛΑΓΚΑΔΑ,ΘΕΣ/ΝΙΚΗΣ,41103,37072,-4031,"-9,8%"
ΝΕΑΠΟΛΗΣ-ΣΥΚΕΩΝ,ΘΕΣ/ΝΙΚΗΣ,84741,80851,-3890,"-4,6%"
ΠΑΥΛΟΥ ΜΕΛΑ,ΘΕΣ/ΝΙΚΗΣ,99245,99969,724,"0,7%"
ΠΥΛΑΙΑΣ-ΧΟΡΤΙΑΤΗ,ΘΕΣ/ΝΙΚΗΣ,70110,72223,2113,"3,0%"
ΧΑΛΚΗΔΟΝΟΣ,ΘΕΣ/ΝΙΚΗΣ,33673,29951,-3722,"-11,1%"
ΩΡΑΙΟΚΑΣΤΡΟΥ,ΘΕΣ/ΝΙΚΗΣ,38317,40114,1797,"4,7%"
ΒΟΡΕΙΩΝ ΤΖΟΥΜΕΡΚΩΝ,ΙΩΑΝΝΙΝΩΝ,5714,5075,-639,"-11,2%"
ΔΩΔΩΝΗΣ,ΙΩΑΝΝΙΝΩΝ,9693,7258,-2435,"-25,1%"
ΖΑΓΟΡΙΟΥ,ΙΩΑΝΝΙΝΩΝ,3724,3384,-340,"-9,1%"
ΖΙΤΣΑΣ,ΙΩΑΝΝΙΝΩΝ,14766,13630,-1136,"-7,7%"
ΙΩΑΝΝΙΤΩΝ,ΙΩΑΝΝΙΝΩΝ,112486,113094,608,"0,5%"
ΚΟΝΙΤΣΑΣ,ΙΩΑΝΝΙΝΩΝ,6362,5325,-1037,"-16,3%"
ΜΕΤΣΟΒΟΥ,ΙΩΑΝΝΙΝΩΝ,6196,5429,-767,"-12,4%"
ΠΩΓΩΝΙΟΥ,ΙΩΑΝΝΙΝΩΝ,8960,6859,-2101,"-23,4%"
ΘΑΣΟΥ,ΚΑΒΑΛΑΣ,13770,13055,-715,"-5,2%"
ΚΑΒΑΛΑΣ,ΚΑΒΑΛΑΣ,70501,65857,-4644,"-6,6%"
ΝΕΣΤΟΥ,ΚΑΒΑΛΑΣ,22331,20525,-1806,"-8,1%"
ΠΑΓΓΑΙΟΥ,ΚΑΒΑΛΑΣ,32085,29592,-2493,"-7,8%"
ΑΡΓΙΘΕΑΣ,ΚΑΡΔΙΤΣΑΣ,3450,3515,65,"1,9%"
ΚΑΡΔΙΤΣΑΣ,ΚΑΡΔΙΤΣΑΣ,56747,56641,-106,"-0,2%"
ΛΙΜΝΗΣ ΠΛΑΣΤΗΡΑ,ΚΑΡΔΙΤΣΑΣ,4635,5285,650,"14,0%"
ΜΟΥΖΑΚΙΟΥ,ΚΑΡΔΙΤΣΑΣ,13122,11264,-1858,"-14,2%"
ΠΑΛΑΜΑ,ΚΑΡΔΙΤΣΑΣ,16726,13416,-3310,"-19,8%"
ΣΟΦΑΔΩΝ,ΚΑΡΔΙΤΣΑΣ,18864,16577,-2287,"-12,1%"
ΑΡΓΟΥΣ ΟΡΕΣΤΙΚΟΥ,ΚΑΣΤΟΡΙΑΣ,11802,10633,-1169,"-9,9%"
ΚΑΣΤΟΡΙΑΣ,ΚΑΣΤΟΡΙΑΣ,35874,33227,-2647,"-7,4%"
ΝΕΣΤΟΡΙΟΥ,ΚΑΣΤΟΡΙΑΣ,2646,2188,-458,"-17,3%"
ΒΟΡΕΙΑΣ ΚΕΡΚΥΡΑΣ,ΚΕΡΚΥΡΑΣ,17832,17455,-377,"-2,1%"
ΚΕΝΤΡΙΚΗΣ ΚΕΡΚΥΡΑΣ        ΚΑΙ        ΔΙΑΠΟΝΤΙΩΝ        ΝΗΣΩΝ,ΚΕΡΚΥΡΑΣ,68558,65237,-3321,"-4,8%"
ΝΟΤΙΑΣ ΚΕΡΚΥΡΑΣ,ΚΕΡΚΥΡΑΣ,15681,14772,-909,"-5,8%"
ΠΑΞΩΝ,ΚΕΡΚΥΡΑΣ,2300,2383,83,"3,6%"
ΑΡΓΟΣΤΟΛΙΟΥ,ΚΕΦ/ΝΙΑΣ,23499,22388,-1111,"-4,7%"
ΙΘΑΚΗΣ,ΚΕΦ/ΝΙΑΣ,3231,2774,-457,"-14,1%"
ΛΗΞΟΥΡΙΟΥ,ΚΕΦ/ΝΙΑΣ,7098,7025,-73,"-1,0%"
ΣΑΜΗΣ,ΚΕΦ/ΝΙΑΣ,5204,5511,307,"5,9%"
ΚΙΛΚΙΣ,ΚΙΛΚΙΣ,51926,45489,-6437,"-12,4%"
ΠΑΙΟΝΙΑΣ,ΚΙΛΚΙΣ,28493,25159,-3334,"-11,7%"
ΒΕΛΒΕΝΤΟΥ,ΚΟΖΑΝΗΣ,3448,3060,-388,"-11,3%"
ΒΟΪΟΥ,ΚΟΖΑΝΗΣ,18386,15080,-3306,"-18,0%"
ΕΟΡΔΑΙΑΣ,ΚΟΖΑΝΗΣ,45592,42414,-3178,"-7,0%"
ΚΟΖΑΝΗΣ,ΚΟΖΑΝΗΣ,71388,67161,-4227,"-5,9%"
ΣΕΡΒΙΩΝ,ΚΟΖΑΝΗΣ,11382,9486,-1896,"-16,7%"
ΒΕΛΟΥ-ΒΟΧΑΣ,ΚΟΡΙΝΘΙΑΣ,19027,17836,-1191,"-6,3%"
ΚΟΡΙΝΘΙΩΝ,ΚΟΡΙΝΘΙΑΣ,58192,56437,-1755,"-3,0%"
ΛΟΥΤΡΑΚΙΟΥ-ΠΕΡΑΧΩΡΑΣ-ΑΓΙΩΝ ΘΕΟΔΩΡΩΝ,ΚΟΡΙΝΘΙΑΣ,21221,21925,704,"3,3%"
ΝΕΜΕΑΣ,ΚΟΡΙΝΘΙΑΣ,6483,5668,-815,"-12,6%"
ΞΥΛΟΚΑΣΤΡΟΥ-ΕΥΡΩΣΤΙΝΗΣ,ΚΟΡΙΝΘΙΑΣ,17365,15295,-2070,"-11,9%"
ΣΙΚΥΩΝΙΩΝ,ΚΟΡΙΝΘΙΑΣ,22794,20983,-1811,"-7,9%"
ΑΜΟΡΓΟΥ,ΚΥΚΛΑΔΩΝ,1973,1965,-8,"-0,4%"
ΑΝΑΦΗΣ,ΚΥΚΛΑΔΩΝ,271,291,20,"7,4%"
ΑΝΔΡΟΥ,ΚΥΚΛΑΔΩΝ,9221,8883,-338,"-3,7%"
ΑΝΤΙΠΑΡΟΥ,ΚΥΚΛΑΔΩΝ,1211,1264,53,"4,4%"
ΘΗΡΑΣ,ΚΥΚΛΑΔΩΝ,15550,15457,-93,"-0,6%"
ΙΗΤΩΝ,ΚΥΚΛΑΔΩΝ,2024,2297,273,"13,5%"
ΚΕΑΣ,ΚΥΚΛΑΔΩΝ,2455,2394,-61,"-2,5%"
ΚΙΜΩΛΟΥ,ΚΥΚΛΑΔΩΝ,910,817,-93,"-10,2%"
ΚΥΘΝΟΥ,ΚΥΚΛΑΔΩΝ,1456,1492,36,"2,5%"
ΜΗΛΟΥ,ΚΥΚΛΑΔΩΝ,4977,5193,216,"4,3%"
ΜΥΚΟΝΟΥ,ΚΥΚΛΑΔΩΝ,10134,9802,-332,"-3,3%"
ΝΑΞΟΥ ΚΑΙ	ΜΙΚΡΩΝ	ΚΥΚΛΑΔΩΝ,ΚΥΚΛΑΔΩΝ,18904,19812,908,"4,8%"
ΠΑΡΟΥ,ΚΥΚΛΑΔΩΝ,13715,14290,575,"4,2%"
ΣΕΡΙΦΟΥ,ΚΥΚΛΑΔΩΝ,1420,1258,-162,"-11,4%"
ΣΙΚΙΝΟΥ,ΚΥΚΛΑΔΩΝ,273,253,-20,"-7,3%"
ΣΙΦΝΟΥ,ΚΥΚΛΑΔΩΝ,2625,2755,130,"5,0%"
ΣΥΡΟΥ-ΕΡΜΟΥΠΟΛΗΣ,ΚΥΚΛΑΔΩΝ,21507,20791,-716,"-3,3%"
ΤΗΝΟΥ,ΚΥΚΛΑΔΩΝ,8636,8611,-25,"-0,3%"
ΦΟΛΕΓΑΝΔΡΟΥ,ΚΥΚΛΑΔΩΝ,765,715,-50,"-6,5%"
ΑΝΑΤΟΛΙΚΗΣ ΜΑΝΗΣ,ΛΑΚΩΝΙΑΣ,13005,12805,-200,"-1,5%"
ΕΛΑΦΟΝΗΣΟΥ,ΛΑΚΩΝΙΑΣ,1041,913,-128,"-12,3%"
ΕΥΡΩΤΑ,ΛΑΚΩΝΙΑΣ,17891,16018,-1873,"-10,5%"
ΜΟΝΕΜΒΑΣΙΑΣ,ΛΑΚΩΝΙΑΣ,21942,21815,-127,"-0,6%"
ΣΠΑΡΤΗΣ,ΛΑΚΩΝΙΑΣ,35259,32918,-2341,"-6,6%"
ΑΓΙΑΣ,ΛΑΡΙΣΑΣ,11470,10705,-765,"-6,7%"
ΕΛΑΣΣΟΝΑΣ,ΛΑΡΙΣΑΣ,32121,25441,-6680,"-20,8%"
ΚΙΛΕΛΕΡ,ΛΑΡΙΣΑΣ,20854,18068,-2786,"-13,4%"
ΛΑΡΙΣΑΙΩΝ,ΛΑΡΙΣΑΣ,162591,164381,1790,"1,1%"
ΤΕΜΠΩΝ,ΛΑΡΙΣΑΣ,13712,11994,-1718,"-12,5%"
ΤΥΡΝΑΒΟΥ,ΛΑΡΙΣΑΣ,25032,22252,-2780,"-11,1%"
ΦΑΡΣΑΛΩΝ,ΛΑΡΙΣΑΣ,18545,16310,-2235,"-12,1%"
ΑΓΙΟΥ ΝΙΚΟΛΑΟΥ,ΛΑΣΙΘΙΟΥ,27074,26937,-137,"-0,5%"
ΙΕΡΑΠΕΤΡΑΣ,ΛΑΣΙΘΙΟΥ,26200,26410,210,"0,8%"
ΟΡΟΠΕΔΙΟΥ ΛΑΣΙΘΙΟΥ,ΛΑΣΙΘΙΟΥ,2387,2285,-102,"-4,3%"
ΣΗΤΕΙΑΣ,ΛΑΣΙΘΙΟΥ,19720,20268,548,"2,8%"
ΑΓΙΟΥ ΕΥΣΤΡΑΤΙΟΥ,ΛΕΣΒΟΥ,270,257,-13,"-4,8%"
ΔΥΤΙΚΗΣ ΛΕΣΒΟΥ,ΛΕΣΒΟΥ,28564,24783,-3781,"-13,2%"
ΛΗΜΝΟΥ,ΛΕΣΒΟΥ,16992,16458,-534,"-3,1%"
ΜΥΤΙΛΗΝΗΣ,ΛΕΣΒΟΥ,57872,58285,413,"0,7%"
ΛΕΥΚΑΔΑΣ,ΛΕΥΚΑΔΟΣ,22652,21759,-893,"-3,9%"
ΜΕΓΑΝΗΣΙΟΥ,ΛΕΥΚΑΔΟΣ,1041,914,-127,"-12,2%"
ΑΛΜΥΡΟΥ,ΜΑΓΝΗΣΙΑΣ,18614,16004,-2610,"-14,0%"
ΑΛΟΝΝΗΣΟΥ,ΜΑΓΝΗΣΙΑΣ,2750,3153,403,"14,7%"
ΒΟΛΟΥ,ΜΑΓΝΗΣΙΑΣ,144449,138865,-5584,"-3,9%"
ΖΑΓΟΡΑΣ-ΜΟΥΡΕΣΙΟΥ,ΜΑΓΝΗΣΙΑΣ,5809,4556,-1253,"-21,6%"
ΝΟΤΙΟΥ ΠΗΛΙΟΥ,ΜΑΓΝΗΣΙΑΣ,10216,8322,-1894,"-18,5%"
ΡΗΓΑ ΦΕΡΑΙΟΥ,ΜΑΓΝΗΣΙΑΣ,10922,8841,-2081,"-19,1%"
ΣΚΙΑΘΟΥ,ΜΑΓΝΗΣΙΑΣ,6088,5499,-589,"-9,7%"
ΣΚΟΠΕΛΟΥ,ΜΑΓΝΗΣΙΑΣ,4960,4377,-583,"-11,8%"
ΔΥΤΙΚΗΣ ΜΑΝΗΣ,ΜΕΣΣΗΝΙΑΣ,6945,5772,-1173,"-16,9%"
ΚΑΛΑΜΑΤΑΣ,ΜΕΣΣΗΝΙΑΣ,69849,71894,2045,"2,9%"
ΜΕΣΣΗΝΗΣ,ΜΕΣΣΗΝΙΑΣ,23482,19200,-4282,"-18,2%"
ΟΙΧΑΛΙΑΣ,ΜΕΣΣΗΝΙΑΣ,11228,8508,-2720,"-24,2%"
ΠΥΛΟΥ-ΝΕΣΤΟΡΟΣ,ΜΕΣΣΗΝΙΑΣ,21077,17179,-3898,"-18,5%"
ΤΡΙΦΥΛΙΑΣ,ΜΕΣΣΗΝΙΑΣ,27373,22367,-5006,"-18,3%"
ΑΒΔΗΡΩΝ,ΞΑΝΘΗΣ,19005,17860,-1145,"-6,0%"
ΜΥΚΗΣ,ΞΑΝΘΗΣ,15540,14521,-1019,"-6,6%"
ΞΑΝΘΗΣ,ΞΑΝΘΗΣ,65133,66162,1029,"1,6%"
ΤΟΠΕΙΡΟΥ,ΞΑΝΘΗΣ,11544,9634,-1910,"-16,5%"
ΑΛΜΩΠΙΑΣ,ΠΕΛΛΑΣ,27556,24924,-2632,"-9,6%"
ΕΔΕΣΣΑΣ,ΠΕΛΛΑΣ,28814,26336,-2478,"-8,6%"
ΠΕΛΛΑΣ,ΠΕΛΛΑΣ,63122,56918,-6204,"-9,8%"
ΣΚΥΔΡΑΣ,ΠΕΛΛΑΣ,20188,18080,-2108,"-10,4%"
ΔΙΟΥ-ΟΛΥΜΠΟΥ,ΠΙΕΡΙΑΣ,25668,23984,-1684,"-6,6%"
ΚΑΤΕΡΙΝΗΣ,ΠΙΕΡΙΑΣ,85851,82971,-2880,"-3,4%"
ΠΥΔΝΑΣ-ΚΟΛΙΝΔΡΟΥ,ΠΙΕΡΙΑΣ,15179,12531,-2648,"-17,4%"
ΖΗΡΟΥ,ΠΡΕΒΕΖΗΣ,13892,13071,-821,"-5,9%"
ΠΑΡΓΑΣ,ΠΡΕΒΕΖΗΣ,11866,10771,-1095,"-9,2%"
ΠΡΕΒΕΖΑΣ,ΠΡΕΒΕΖΗΣ,31733,30893,-840,"-2,6%"
ΑΓΙΟΥ ΒΑΣΙΛΕΙΟΥ,ΡΕΘΥΜΝΟΥ,7427,7194,-233,"-3,1%"
ΑΜΑΡΙΟΥ,ΡΕΘΥΜΝΟΥ,5915,5607,-308,"-5,2%"
ΑΝΩΓΕΙΩΝ,ΡΕΘΥΜΝΟΥ,2379,2240,-139,"-5,8%"
ΜΥΛΟΠΟΤΑΜΟΥ,ΡΕΘΥΜΝΟΥ,14363,12890,-1473,"-10,3%"
ΡΕΘΥΜΝΗΣ,ΡΕΘΥΜΝΟΥ,55525,55636,111,"0,2%"
ΑΡΡΙΑΝΩΝ,ΡΟΔΟΠΗΣ,16577,14944,-1633,"-9,9%"
ΙΑΣΜΟΥ,ΡΟΔΟΠΗΣ,13810,12346,-1464,"-10,6%"
ΚΟΜΟΤΗΝΗΣ,ΡΟΔΟΠΗΣ,66919,65107,-1812,"-2,7%"
ΜΑΡΩΝΕΙΑΣ-ΣΑΠΩΝ,ΡΟΔΟΠΗΣ,14733,11983,-2750,"-18,7%"
ΑΝΑΤΟΛΙΚΗΣ ΣΑΜΟΥ,ΣΑΜΟΥ,20513,20025,-488,"-2,4%"
ΔΥΤΙΚΗΣ ΣΑΜΟΥ,ΣΑΜΟΥ,12464,12608,144,"1,2%"
ΙΚΑΡΙΑΣ,ΣΑΜΟΥ,8423,8555,132,"1,6%"
ΦΟΥΡΝΩΝ ΚΟΡΣΕΩΝ,ΣΑΜΟΥ,1459,1346,-113,"-7,7%"
ΑΜΦΙΠΟΛΗΣ,ΣΕΡΡΩΝ,9182,7169,-2013,"-21,9%"
ΒΙΣΑΛΤΙΑΣ,ΣΕΡΡΩΝ,20030,16032,-3998,"-20,0%"
ΕΜΜΑΝΟΥΗΛ ΠΑΠΠΑ,ΣΕΡΡΩΝ,14664,11574,-3090,"-21,1%"
ΗΡΑΚΛΕΙΑΣ,ΣΕΡΡΩΝ,21145,15711,-5434,"-25,7%"
ΝΕΑΣ ΖΙΧΝΗΣ,ΣΕΡΡΩΝ,12397,8259,-4138,"-33,4%"
ΣΕΡΡΩΝ,ΣΕΡΡΩΝ,76817,73847,-2970,"-3,9%"
ΣΙΝΤΙΚΗΣ,ΣΕΡΡΩΝ,22195,19532,-2663,"-12,0%"
ΜΕΤΕΩΡΩΝ,ΤΡΙΚΑΛΩΝ,21991,19290,-2701,"-12,3%"
ΠΥΛΗΣ,ΤΡΙΚΑΛΩΝ,14343,12915,-1428,"-10,0%"
ΤΡΙΚΚΑΙΩΝ,ΤΡΙΚΑΛΩΝ,81355,78508,-2847,"-3,5%"
ΦΑΡΚΑΔΟΝΑΣ,ΤΡΙΚΑΛΩΝ,13396,11348,-2048,"-15,3%"
ΑΜΦΙΚΛΕΙΑΣ-ΕΛΑΤΕΙΑΣ,ΦΘΙΩΤΙΔΑΣ,10922,8381,-2541,"-23,3%"
ΔΟΜΟΚΟΥ,ΦΘΙΩΤΙΔΑΣ,11495,9178,-2317,"-20,2%"
ΚΑΜΕΝΩΝ ΒΟΥΡΛΩΝ,ΦΘΙΩΤΙΔΑΣ,12090,10901,-1189,"-9,8%"
ΛΑΜΙΕΩΝ,ΦΘΙΩΤΙΔΑΣ,75315,66472,-8843,"-11,7%"
ΛΟΚΡΩΝ,ΦΘΙΩΤΙΔΑΣ,19623,17854,-1769,"-9,0%"
ΜΑΚΡΑΚΩΜΗΣ,ΦΘΙΩΤΙΔΑΣ,16036,13553,-2483,"-15,5%"
ΣΤΥΛΙΔΑΣ,ΦΘΙΩΤΙΔΑΣ,12750,11417,-1333,"-10,5%"
ΑΜΥΝΤΑΙΟΥ,ΦΛΩΡΙΝΑΣ,16973,14331,-2642,"-15,6%"
ΠΡΕΣΠΩΝ,ΦΛΩΡΙΝΑΣ,1560,1220,-340,"-21,8%"
ΦΛΩΡΙΝΑΣ,ΦΛΩΡΙΝΑΣ,32881,29611,-3270,"-9,9%"
ΔΕΛΦΩΝ,ΦΩΚΙΔΑΣ,26716,24160,-2556,"-9,6%"
ΔΩΡΙΔΟΣ,ΦΩΚΙΔΑΣ,13627,12050,-1577,"-11,6%"
ΑΡΙΣΤΟΤΕΛΗ,ΧΑΛΚΙΔΙΚΗΣ,18294,16994,-1300,"-7,1%"
ΚΑΣΣΑΝΔΡΑΣ,ΧΑΛΚΙΔΙΚΗΣ,16672,16958,286,"1,7%"
ΝΕΑΣ ΠΡΟΠΟΝΤΙΔΑΣ,ΧΑΛΚΙΔΙΚΗΣ,36500,34391,-2109,"-5,8%"
ΠΟΛΥΓΥΡΟΥ,ΧΑΛΚΙΔΙΚΗΣ,22048,21350,-698,"-3,2%"
ΣΙΘΩΝΙΑΣ,ΧΑΛΚΙΔΙΚΗΣ,12394,11631,-763,"-6,2%"
ΑΠΟΚΟΡΩΝΟΥ,ΧΑΝΙΩΝ,12807,11771,-1036,"-8,1%"
ΓΑΥΔΟΥ,ΧΑΝΙΩΝ,152,151,-1,"-0,7%"
ΚΑΝΤΑΝΟΥ-ΣΕΛΙΝΟΥ,ΧΑΝΙΩΝ,5431,4931,-500,"-9,2%"
ΚΙΣΣΑΜΟΥ,ΧΑΝΙΩΝ,10790,10632,-158,"-1,5%"
ΠΛΑΤΑΝΙΑ,ΧΑΝΙΩΝ,16874,15320,-1554,"-9,2%"
ΣΦΑΚΙΩΝ,ΧΑΝΙΩΝ,1889,1992,103,"5,5%"
ΧΑΝΙΩΝ,ΧΑΝΙΩΝ,108642,110646,2004,"1,8%"
ΗΡΩΙΚΗΣ ΝΗΣΟΥ	ΨΑΡΩΝ,ΧΙΟΥ,458,420,-38,"-8,3%"
ΟΙΝΟΥΣΣΩΝ,ΧΙΟΥ,826,916,90,"10,9%"
ΧΙΟΥ,ΧΙΟΥ,51390,50483,-907,"-1,8%"